1111111
1P0C001
1C00EC1
1111111