111111111
1P01000C1
1 00000E1
111111111