111111111111111111111111111111111111111111111111111111111111
100010C010C010C010C010C010C010C010C010C010C010C010C010C010E1
101010101010101010101010101010101010101010101010101010101011
101010101010101010101010101010101010101010101010101010101011
101010101010101010101010101010101010101010101010101010101011
101010101010101010101010101010101010101010101010101010101011
101010101010101010101010101010101010101010101010101010101011
101010101010101010101010101010101010101010101010101010101011
101010101010101010101010101010101010101010101010101010101011
101010101010101010101010101010101010101010101010101010101011
101010101010101010101010101010101010101010101010101010101011
101010101010101010101010101010101010101010101010101010101011
101010101010101010101010101010101010101010101010101010101011
101010101010101010101010101010101010101010101010101010101011
101010101010101010101010101010101010101010101000101010100011
101010101010101010101010101010101010101010101010101010101011
101010101010101010101010101010101010101010101010101010101011
101010101010101010101010101010101010101010101010101010101011
101010101010101010101010101010101010101010101010101010101011
101010101010101010101010101010101010101010101010101010101011
101010101010101010101010101010101010101010101010101010101011
101010101010101010101010101010101010101010101010101010101011
101010101010101010101010101010101010101010101010101010101011
101010101010101010101010101010101010101010101010101010101011
101010101010101010101010101010101010101010101010101010101011
101010101010101010101010101010101010101010101010101010101011
101010101010101010101010101010101010101010101010101010101011
101010101010101010101010101010101010101010101010101010101011
101010101010101010101010101010101010101010101010101010101011
1P1C0010C010C010C010C010C010C010C010C010C010C010C010C010C011
111111111111111111111111111111111111111111111111111111111111