1111111111111111111111111111111111
1000000000000000000000000000000E01
1011001100110011001100110110011001
10110110000101111C110001S100001001
1P00000000000000000000000000000001
1111111111111111111111111111111111